EA  assets/East.xpm
WE      assets/West.xpm
SO  assets/South.xpm
NO                              assets/North.xpm


F  255, 255, 255
C  255, 255, 0



11111111111111
100000000000011
10N000000000011
10000001110011
11100010100011
10000011100001
11111111111111