EA  ./path_to_the_east_texture
WE ./path_to_the_west_texture
SO  ./path_to_the_south_texture
NO  ./path_to_the_north_texture


F  220,      100, 0
C  225,30, 0

111111111
10000N001
111111111