EA  assets/East.xpm
WE      assets/West.xpm
SO  assets/South.xpm
NO                              assets/North.xpm


F  255, 255, 255
C  255, 255, 0



        1111111111111111111111111
        1000000000110000000000001
        1011000001110000000000001
        1001000000000000000000001
111111111011000001110000000000001
100000000011000001110111111111111
11110111111111011100000010001
11110111111111011101011110001
1100000011010101110001 1110001
10000000000000001100001100001
1000000000W0000001101010010001
1100000111010101111101111000111
1111011101110101 101111010001
1111111111111111 111111111111