EA  assets/East.xpm
WE      assets/West.xpm
SO  assets/South.xpm
NO                              assets/North.xpm


F  220,      100, 0
C  225,30, 0




11111
10001
10001
10001
10001
100011
1000N1
100011
11111
